11111111111111
1000P0000000C1
10000000000001
10000000000001
10000000001111
10000000001001
11111111110111