11111111111111
1000P000E000C1
11110111101111
11111111111111