11111111111111
10000000000001
11110111101111
11111111111111
